[
  {
    "method": "json",
    "om_terrain": "test_1",
    "//": "normal variant",
    "type": "mapgen",
    "weight": 100,
    "object": {
      "fill_ter": "t_floor",
      "rows": [
        ".%.``````p..............",
        ".%.````````````..[......",
        ".%.``````%!!!%`.......[.",
        ".%#~~~~~~##o##*##oo##...",
        "..#~~~~~~#IIT| |DbyE#...",
        ".%#~~~~~~#h  | +    o.[.",
        ".%#~~~~~~#s  + | @@ o...",
        ".^#~~~~~~#@@d| |I@@d#...",
        "..#~~~~~~#|||| |||||#..[",
        "..#~A~~~~#xxxy |66 F#$;$",
        "..#NN~qq~# l   |Y  1o..$",
        "..######*#HHH      O#..$",
        "$;#t--+  |    R|   5o[.$",
        "$.#9S8|L + hfhR|7432#..$",
        "$.##o###*##ooo###oo##..$",
        "$.....`````!!!%%%!!^...$",
        "$.....`````............$",
        "$.....................[$",
        "$......................$",
        "$......................$",
        "$......................$",
        "$......................$",
        "$......................$",
        "$$$$$$$$$$$$$$$$$$$$$$$$"
      ],
      "palettes": [ "test_1_palette" ],
      "terrain": {
        "%": [ "t_region_shrub", "t_region_shrub_fruit", "t_region_shrub_decorative" ],
        "[": [ [ "t_region_tree_fruit", 2 ], [ "t_region_tree_nut", 2 ], "t_region_tree_shade" ],
        "!": "t_region_groundcover_urban",
        "`": "t_concrete",
        "$": "t_privacy_fence",
        ";": "t_privacy_fencegate_c",
        "#": "t_wall_wood",
        "-": "t_linoleum_white",
        "Q": "t_linoleum_white",
        "8": "t_linoleum_white",
        "B": "t_linoleum_white",
        "S": "t_linoleum_white",
        "t": "t_linoleum_white",
        ")": "t_wall_glass",
        "]": "t_door_glass_c",
        "N": "t_thconc_floor",
        "q": "t_thconc_floor",
        "A": "t_thconc_floor",
        "~": "t_thconc_floor"
      },
      "furniture": { "!": "f_region_flower" },
      "place_loot": 
      [ { "group": "lingqi_group", "x": 0, "y": 0 },
        { "group": "manual_magic_deep_bead_group", "x": [ 0,5 ], "y": [ 0,5 ], "chance": 90, "repeat": [ 10, 20 ] },
        { "group": "manual_magic_deep_bead_group", "x": 21, "y": [ 1, 17 ], "chance": 10, "repeat": [ 1, 12 ] }
      ],
      "place_monster": [ { "monster": "mon_san_xiu", "x": [ 0, 18 ], "y": [ 0, 18 ], "chance": 100, "repeat": 4 } ],
      "place_nested": [
        {
          "chunks": [
            [ "roof_6x6_garden_4", 15 ],
            [ "roof_6x6_garden_1", 15 ],
            [ "greenhouse_6x6_herbal", 15 ],
            [ "greenhouse_6x6_vegetable", 15 ],
            [ "pond_6x6", 15 ],
            [ "shed_6x6_junk", 15 ],
            [ "shed_6x6_woodworker", 15 ],
            [ "playset_4x4_2", 15 ],
            [ "firepit_5x5_1", 15 ],
            [ "firepit_5x5_2", 15 ],
            [ "playset_4x4_1", 15 ]
          ],
          "x": [ 4, 13 ],
          "y": 17
        }
      ]
    }
  },
  {
    "type": "mapgen",
    "method": "json",
    "om_terrain": "test_1_roof",
    "object": {
      "fill_ter": "t_shingle_flat_roof",
      "rows": [
        "                        ",
        "                        ",
        "                        ",
        "  |222222222222222223   ",
        "  |.................3   ",
        "  |.................3   ",
        "  |.............N...3   ",
        "  5.................3   ",
        "  |.................3   ",
        "  |.................3   ",
        "  |........&........3   ",
        "  |.................3   ",
        "  |......=..........3   ",
        "  |.................3   ",
        "  |----------------53   ",
        "                        ",
        "                        ",
        "                        ",
        "                        ",
        "                        ",
        "                        ",
        "                        ",
        "                        ",
        "                        "
      ],
      "palettes": [ "roof_palette" ],
      "terrain": { ".": "t_shingle_flat_roof" }
    }
  }
]
